2222222222222222222222222
0000000000000000000000000
0000000000000000000000000
0000000000000000000000000
0000050000000000000000000
0000000000000000000000000
2222220000000000000020000
0000000020000000002222222
0000000000000000000000000
0000000022000000000000000
2000002200000400000000000
0002000000000000000002000
2222222222222222222222222
